04,04,04,04,04,04,04,04,04,04,04,04,04,04,04,04,04,04,04,04
04,04,04,04,04,04,04,03,03,03,03,03,03,04,04,04,04,04,04,04
04,04,04,04,04,04,04,03,03,03,03,03,03,04,04,04,04,04,04,04
04,04,04,04,04,04,04,03,03,03,03,03,03,04,04,04,04,04,04,04
04,04,04,04,04,04,04,03,03,02,02,03,03,04,04,04,04,04,04,04
04,04,04,04,04,04,04,01,01,00,00,01,01,04,04,04,04,04,04,04
04,04,04,04,04,04,04,05,05,05,05,05,05,04,04,04,04,04,04,04
04,04,04,04,04,04,04,04,04,04,04,04,04,04,04,04,04,04,04,04
04,04,04,04,04,04,04,04,04,04,04,04,04,04,04,04,04,04,04,04
04,04,04,04,04,04,04,04,04,04,04,04,04,04,04,04,04,04,04,04
04,04,04,04,04,04,04,04,04,04,04,04,04,04,04,04,04,04,04,04
04,04,04,04,04,04,04,04,04,04,04,04,04,04,04,04,04,04,04,04
04,04,04,04,04,04,04,04,04,04,04,04,04,04,04,04,04,04,04,04
04,04,04,04,04,04,04,04,04,04,04,04,04,04,04,04,04,04,04,04
04,04,04,04,04,04,04,04,04,04,04,04,04,04,04,04,04,04,04,04

1,1,1,1,1,1,1,1,1,1,1,1,1,1,1,1,1,1,1,1
1,0,0,0,0,0,0,1,1,1,1,1,1,0,0,0,0,0,0,1
1,0,0,0,0,0,0,1,0,0,0,0,1,0,0,0,0,0,0,1
1,0,0,0,0,0,0,1,0,0,0,0,1,0,0,0,0,0,0,1
1,0,0,0,0,0,0,1,0,0,0,0,1,0,0,0,0,0,0,1
1,0,0,0,0,0,0,1,1,2,2,1,1,0,0,0,0,0,0,1
1,0,0,0,0,0,0,0,0,0,0,0,0,0,0,0,0,0,0,1
1,0,0,0,0,0,0,0,0,0,0,0,0,0,0,0,0,0,0,1
1,0,0,0,0,0,0,0,0,0,0,0,0,0,0,0,0,0,0,1
1,0,0,0,0,0,0,0,0,0,0,0,0,0,0,0,0,0,0,1
1,0,0,0,0,0,0,0,0,0,0,0,0,0,0,0,0,0,0,1
1,0,0,0,0,0,0,0,0,0,0,0,0,0,0,0,0,0,0,1
1,0,0,0,0,0,0,0,0,0,0,0,0,0,0,0,0,0,0,1
1,0,0,0,0,0,0,0,0,0,0,0,0,0,0,0,0,0,0,1
1,1,1,1,1,1,1,1,1,1,1,1,1,1,1,1,1,1,1,1

